Alley	Scenes of Alleys
Alligator	Scenes with Alligators
Anhinga	Scenes with Anhinga Birds
Animal pen	Scenes of Animal Pens
Animal	Scenes with Animals
Attic	Scenes of Attics
Basket	Scenes with Baskets
Bay	Scenes of Bays or Coves
Bed	Scenes with Beds
Bench	Scenes with Benches
Bird	Scenes with Birds
Boat	Scenes with Boats or Ships
Branch	Scenes with Tree Branches
Brick	Scenes with Bricks or Brickwork
Bridge	Scenes of Bridges
Brush	Scenes of Dense Brush or Scrub
Building	Scenes of Buildings
Bush	Scenes with Bushes or Shrubs
Butterfly	Scenes with Butterflies
Cabin	Scenes of Cabins
Cactus	Scenes with Cactus Plants
Camp	Scenes of Camps or Campsites
Campfire	Scenes with a Campfire
Candle	Scenes with Candles
Cannon	Scenes with Cannons
Canyon	Scenes of Canyons
Cardinal	Scenes with Cardinal Birds
Cemetary	Scenes of Cemetaries
Chair	Scenes with Chairs
Chipmunk	Scenes with Chipmunks
Children	Scenes with Children
Church	Scenes of Churches
City	Scenes of Cities or Urban Areas
Clock	Scenes with Clocks
Clouds	Scenes with Clouds
Columns	Scenes with Architectural Columns
Coral	Scenes of Coral or Coral Reefs
Cormorant	Scenes with Cormorants
Corn	Scenes with Corn or Cornfields
Courthouse	Scenes of Courthouses
Cow	Scenes with Cows
Crane	Scenes with Crane Birds
Crops	Scenes with Crops
Crow	Scenes with Crows
Cupola	Scenes with a Cupola
Curtains	Scenes with Curtains
Dawn	Scenes of Dawn or Daybreak
Day	Scenes during the Day
Desert	Scenes of Deserts
Desk	Scenes with Desks
Dice	Scenes with Dice
Dirt road	Scenes of Dirt Roads
Door	Scenes with Doors or Doorways
Dragonfly	Scenes with Dragonflies
Dune	Scenes of Sand Dunes
Dusk	Scenes of Dusk or Twilight
Eagle	Scenes with Eagles
Egret	Scenes with Egrets
Enslaved quarters	Scenes of Enslaved Quarters
Enslaved cabin	Scenes of Enslaved Cabins
Evening	Scenes during the Evening
Fall	Scenes of the Fall/Autumn Season
Families	Scenes with Families
Farm	Scenes of Farms
Fence	Scenes with Fences
Field	Scenes of Fields
Fire	Scenes with Fire or Flames
Fireplace	Scenes with a Fireplace
Firewood	Scenes with Firewood
Fish	Scenes with Fish
Flower	Scenes with Flowers
Fog	Scenes with Fog or Mist
Food	Scenes with Food
Forest	Scenes of Forests or Woods
Garden	Scenes of Gardens
Gate	Scenes with Gates
Glasses	Scenes with Drinking Glasses
Goose	Scenes with Geese
Grass	Scenes with Grass
Grasshopper	Scenes with Grasshoppers
Grassland	Scenes of Grasslands
Gravel road	Scenes of Gravel Roads
Gravestone	Scenes with Gravestones
Gun	Scenes with Guns or Firearms
Heron	Scenes with Herons
Hill	Scenes of Hills or Hilltops
Horse	Scenes with Horses
House	Scenes of Houses
Ibis	Scenes with Ibis Birds
Indigenous culture	Scenes of Indigenous Culture
Insect	Scenes with Insects
Kettle	Scenes with Kettles
Lake	Scenes of Lakes
Landmark	Scenes with Landmarks
Lantern	Scenes with Lanterns
Leaves	Scenes with Leaves
Lily pad	Scenes with Lily Pads
Log cabin	Scenes of Log Cabins
Marsh	Scenes of Marshes or Swamps
Mattress	Scenes with Mattresses
Mirror	Scenes with Mirrors
Mist	Scenes with Mist or Light Fog
Moon	Scenes with the Moon
Morning	Scenes during the Morning
Moss	Scenes with Moss or Lichen
Mountain	Scenes of Mountains
Mud	Scenes with Mud or Dirt
Night	Scenes during the Night
Oak	Scenes with Oak Trees
Ocean	Scenes of the Ocean
Osprey	Scenes with Ospreys
Palm fronds	Scenes with Palm Fronds
Pews	Scenes with Pews
Pine	Scenes with Pine Trees
Plantation	Scenes of Plantations
Plants	Scenes with Plants
Pond	Scenes of Ponds
Prairie	Scenes of Prairies
Puddle	Scenes with Puddles
Pulpit	Scenes with a Pulpit
Railroad	Scenes with a Railroad or Tracks
Rain	Scenes with Rain
Rainbow	Scenes with a Rainbow
Reeds	Scenes with Reeds or Tall Grass
Reflection	Scenes with a Reflection in Water
River	Scenes of Rivers
Road	Scenes of Roads
Rock	Scenes with Rocks or Boulders
Roof	Scenes of Roofs
Ruins	Scenes of Ruins
Sand	Scenes with Sand
Seagull	Scenes with Seagulls
Shadow	Scenes with Shadows
Sheep	Scenes with Sheep
Ship	Scenes with Ships or Vessels
Shrubs	Scenes with Shrubs
Sign	Scenes with Signs or Signage
Sky	Scenes of the Sky
Smoke	Scenes with Smoke
Spider	Scenes with Spiders
Stairs	Scenes with Stairs
Statue	Scenes with a Statue
Stork	Scenes with Storks
Stream	Scenes of Streams
Sun	Scenes with the Sun
Sunrise	Scenes of Sunrise
Sunset	Scenes of Sunset
Swamp	Scenes of Swamps
Table	Scenes with Tables
Tableware	Scenes with Tableware
Teapot	Scenes with Teapots
Thistle	Scenes with Thistles
Tobacco	Scenes with Tobacco Plants
Tools	Scenes with Tools
Trees	Scenes with Trees
Turtle	Scenes with Turtles
Twilight	Scenes of Twilight
Vines	Scenes with Vines
Water	Scenes with Water
Waves	Scenes with Waves
Web	Scenes with Spider Webs
Wetlands	Scenes of Wetlands
Wheat	Scenes with Wheat or Grain
Window	Scenes with Windows
